ital	latn
ğŒ€	a
ğŒ	b
ğŒ‚	c
ğŒƒ	d
ğŒ„	e
ğŒ…	v
ğŒ†	z
ğŒ‡	h
ğŒˆ	Î¸
ğŒ‰	i
ğŒŠ	k
ğŒ‹	l
ğŒŒ	m
ğŒ	n
ğŒ	sá«ˆ
ğŒ	o
ğŒ	p
ğŒ‘	Ïƒ
ğŒ’	q
ğŒ›	r
ğŒ›	r
ğŒ”	s
ğŒ•	t
ğŒ–	u
ğŒ—	sÌ½
ğŒ˜	Ï†
ğŒ™	Ï‡
ğŒš	f
